##########
#.##.....#
#..#.#.#.#
#....###.#
##.#.###.#
##.#...#.#
#..#.##..F
#.##...#.#
#S......##
##########